###############################
#o....MM.....................o#
#.######.##.###.###.##.######.#
 .#    #.##.### ###.##.#    #. 
 .#    #.##.#     #.##.#    #. 
#.######.##.#######.##.######.#
#o......................MMo}.o#
###############################